...............
.B.BL..........
.P.............
.B.B.G.........
...............
.B.............
.....C.........
.......QWWAWWWW
.......QWWWAWWW
.......QWWWWAWW
......S..X.H.I.
...............
