...............
.B.B.B.G.......
.P.............
.BLB.G.........
...............
.B.............
.....C.........
.......QWWAWWWW
.......QWWWAWWW
.......QWWWWAWW
......S..X.H.I.
...............