...............
.B.B.B.G.......
.P.............
.BLB...........
...............
...G...........
.....C.........
.......QWWAWWWW
.......QWWWAWWW
.......QWWWWAWW
......S..X.H.K.
...............
